5
5
11111
10001
10001
10031
11111
